1,1,1,1,0,0,0,0,0,0
0,0,0,1,0,0,0,0,0,0
0,16,8,10,2,2,2,0,0,0
0,16,0,8,0,0,2,0,0,0
0,16,0,4,4,4,4,0,0,0
0,16,16,32,0,0,0,0,0,0